"WWWWWWWWWWWWWWWWWWWWWWWWWWWWWWWWWWWWWWWWWWWWWWWWWWWWWWWWWWWWWWWWWWWWWWWWWWWWWW",
"WWWWWWWWWWWWWWWWWWWWWWWWWWWWWWWWWWWWWWWWWWWWWWWWWWWWWWWWWWWWWWWWWWWWWWWWWWWWWW",
"WW                                                               E          WW",
"WW                                                                          WW",
"WW                                                                          WW",
"WW                                                                          WW",
"WW                                                                          WW",
"WW                                                                          WW",
"WW                                                                          WW",
"WW                                                                          WW",
"WW                    WWWWWWWWWWWWWWWWWWWWWWWWWWWWWWWW                      WW",
"WW                    WW                            WW                      WW",
"WW                    WW                            WW                      WW",
"WW                    WW                            WW                      WW",
"WW                    WW                            WW                      WW",
"WW                    WW                            WW                      WW",
"WW                    WW                            WW                      WW",
"WW                    WW                            WW                      WW",
"WW                    WWWWWWWWWWWW     WWWWWWWWWWWWWWW                      WW",
"WW                                                                          WW",
"WW                                                                          WW",
"WW                                                                          WW",
"WW                                                                          WW",
"WW                                                                          WW",
"WW                                                                          WW",
"WW                                                                          WW",
"WW                                                                          WW",
"WW                                                                          WW",
"WW                                                                          WW",
"WW                                                                          WW",
"WW                                                                          WW",
"WW                                                                          WW",
"WW                                WWWW                                      WW",
"WW                                WWWWW                                     WW",
"WW                                WWWWWWW                                   WW",
"WW                                                                          WW",
"WW                                                                          WW",
"WW                                                                          WW",
"WW                                                                          WW",
"WW                                                                          WW",
"WW                                                                          WW",
"WW                                                                          WW",
"WW                                                                          WW",
"WW                                                                          WW",
"WW                                                                          WW",
"WW                                                                          WW",
"WW                                                                          WW",
"WW                                                                          WW",
"WW                                                                          WW",
"WW                                                                          WW",
"WW                                                                          WW",
"WW                                                                          WW",
"WW                                                                          WW",
"WW                                                                          WW",
"WW                                                                          WW",
"WW                                                                          WW",
"WW                                                                          WW",
"WW                                                                          WW",
"WW                                                                          WW",
"WW                                                                          WW",
"WWWWWWWWWWWWWWWWWWWWWWWWWWWWWWWWWWWWWWWWWWWWWWWWWWWWWWWWWWWWWWWWWWWWWWWWWWWWWW",
"WWWWWWWWWWWWWWWWWWWWWWWWWWWWWWWWWWWWWWWWWWWWWWWWWWWWWWWWWWWWWWWWWWWWWWWWWWWWWW"