WWWWWWWWWWWWWWWWWWWWWWWWWWWWWWWWW
WWFFFFFFFFFFFFFFFFFFFFFFFFFFFFFWW
WWFFFFFFFFFFFFFFFFFFFFFFFFFFFFFWW
WWFFFFFFFFFFFFFFFFFFFFFFFFFFFFFWW
WWWWWWWWWWWFFFFFFFFFFFFFFFFFFFFWW
WWFFFFFFFWWFFFFFFFFFFFFFFFFFFFFWW
WWFFFFFFFWWFFFFFFFFFFFFFFFFFFFFWW
WWFFFFFFFWWFFFFFFFFFFWWWWWWWWWWWW
WWFFFFFFFWWWWWWWWWFFFWFFFFFFFFFWW
WWFFFFFFFFFFFFFFFFFFFWFFFFFFFFFWW
WWWWWWWWWWWWWWFFFFFFFWFFFFFFFFFWW
WWFFFFFFFFFFFFFFFFFFFWFFFFFFFFFWW
WWFFFFFFFFFFFFFFFFFFFWFFFFFFFFFWW
WWFFFFFFFFFFFFFFFFFFFWWWWWWFFFFWW
WWFFFFFFFFFFFFFFFFFFFFFFFFFFFFFWW
WWFFFFFFFFFFFFFFFFFFFFFFFFFFFFFWW
WWFFFFFFFFFFFFFFFFFFFFFFFFFFFFFWW
WWWWWWWWWWWWWWWWWWWWWWWWWWWWWWWWW
